01:01:01:01:01:01:01:01:01:01:01:01:01:01:01:01:01:01:01:01:01:01:01:01:01:01:01:01:01:01:01:01:01:01:01:01:01:01:01:01:01:01:01:01:01:01:01:01:01:01:01:01:01:01:01:01:01:01:01:01:01:01:01:01:01:01:01:01:01:01:01:01:01:01:01:01:01:01:01:01:01:01:01:01:
01:00:00:00:01:00:00:00:00:00:00:00:00:00:00:00:00:00:00:00:00:00:00:00:00:00:00:00:00:00:00:00:00:00:00:00:00:00:00:00:00:00:00:00:00:00:00:00:00:00:00:00:00:00:00:00:00:00:00:00:00:00:00:00:00:00:00:00:00:00:00:00:00:00:00:00:00:00:00:00:00:00:00:01:
01:00:00:00:01:00:00:00:00:00:00:00:00:00:00:00:00:00:00:00:00:00:00:00:00:00:00:19:00:00:00:00:00:00:00:00:00:00:00:00:00:00:00:00:00:00:00:00:00:00:00:00:00:00:00:00:00:00:00:00:00:00:00:00:00:00:00:00:00:00:00:00:00:00:00:00:00:00:00:00:00:00:00:01:
01:00:20:00:01:00:00:00:00:00:00:00:00:00:00:00:00:00:00:00:00:00:00:00:00:00:11:01:10:10:11:11:00:01:00:00:00:00:00:00:00:00:00:00:00:00:00:00:18:00:00:00:00:00:00:00:00:00:00:00:00:00:00:00:00:00:00:00:00:00:00:00:00:00:00:00:00:00:00:00:00:00:00:01:
01:09:09:09:01:09:09:09:01:01:00:00:00:00:00:00:00:00:00:22:22:00:00:00:00:00:00:00:00:00:00:00:00:01:01:00:00:00:00:00:00:00:00:00:00:00:11:01:01:01:00:00:00:00:00:00:00:00:00:00:00:00:00:00:00:00:00:00:00:00:00:00:00:00:00:00:00:00:00:00:00:00:00:01:
01:09:09:09:01:09:09:09:01:01:10:00:00:00:00:00:00:00:00:00:00:00:00:00:00:00:00:00:00:00:00:00:00:01:01:01:00:00:00:00:00:00:00:00:00:11:11:12:01:01:01:00:00:00:00:00:00:00:00:00:00:00:00:00:00:00:00:00:00:00:00:00:00:00:00:00:00:00:00:00:00:00:00:01:
01:09:09:09:01:09:09:09:12:01:00:10:00:00:00:00:00:00:00:13:15:00:00:00:00:00:00:00:00:00:00:00:00:01:01:01:10:00:00:00:00:00:00:00:11:11:01:01:00:00:01:01:00:00:00:00:00:00:00:00:00:00:00:00:00:00:00:00:00:00:00:00:00:00:00:00:00:00:00:00:00:21:00:01:
01:09:09:09:01:09:09:09:01:01:00:00:01:18:00:00:00:00:00:00:00:00:00:00:00:00:00:00:04:04:00:00:00:01:00:00:00:10:00:00:00:00:00:11:11:12:01:00:00:00:00:01:01:00:00:00:00:00:00:00:00:00:00:00:00:00:00:00:00:00:00:18:00:00:00:00:00:00:00:01:00:00:00:01:
01:09:09:09:12:09:09:09:01:01:00:00:01:01:00:00:00:00:00:00:00:18:00:00:00:00:00:00:00:00:00:00:00:01:00:00:00:00:01:00:00:00:11:11:01:01:01:00:00:00:00:00:01:01:00:00:00:00:00:00:00:00:00:00:00:18:00:00:00:00:01:01:00:00:00:00:00:00:01:01:00:00:00:01:
01:09:09:09:09:09:09:09:01:01:14:00:01:01:01:00:00:00:13:13:13:13:00:00:00:00:17:17:00:00:17:17:00:01:00:00:01:23:01:01:00:00:00:00:01:01:00:00:01:01:00:14:01:01:01:00:00:00:00:00:01:01:00:00:13:15:13:13:00:00:01:01:00:00:00:00:00:01:01:01:00:00:00:01:
01:09:09:09:09:09:09:09:01:01:00:00:00:00:01:01:00:00:00:00:00:00:00:00:00:00:00:00:00:00:00:00:00:01:00:00:00:00:00:00:01:00:00:00:00:00:00:00:01:01:00:00:00:01:01:00:00:00:00:00:01:01:00:00:00:00:00:00:00:00:01:01:00:00:00:00:01:01:01:01:00:00:00:01:
01:09:09:09:09:09:09:09:01:01:00:00:00:18:01:01:01:00:00:00:00:00:01:00:00:00:00:00:00:00:00:00:00:01:00:18:00:00:00:00:00:10:00:00:00:00:00:01:01:01:00:00:19:01:01:00:00:00:00:00:01:01:00:00:00:00:00:00:00:00:01:01:00:00:00:01:01:01:01:01:00:00:00:01:
01:01:01:01:01:01:01:01:01:01:01:04:01:01:01:01:01:01:01:01:01:01:01:01:01:04:04:04:04:04:04:04:04:01:01:01:01:01:01:01:01:01:01:01:01:01:01:01:01:01:04:01:01:01:01:04:01:01:01:04:01:01:04:01:01:07:07:01:01:04:01:01:04:01:01:01:01:01:01:01:04:04:04:01:
01:02:02:02:02:02:02:02:02:02:02:02:02:02:02:02:02:02:02:02:02:02:02:02:02:02:02:02:02:02:02:02:02:02:02:02:02:02:02:02:02:02:02:02:02:02:02:02:02:02:02:02:02:02:02:02:02:02:02:02:02:02:02:02:02:02:02:02:02:02:02:02:02:02:02:02:02:02:02:02:02:02:02:02:
