01:01:01:01:01:01:01:01:01:01:01:01:01:01:01:01:01:01:01:01:01:01:01:01:01:01:01:01:01:01:01:01:01:01:01:01:01:01:01:01:01:01:01:01:01:01:01:01:01:01:01:01:01:01:01:01:01:01:01:01:01:01:01:01:01:01:01:01:01:01:01:01:01:01:01:01:01:01:01:01:01:01:01:01:
01:00:00:00:00:00:00:00:00:00:00:00:00:00:00:00:00:00:00:00:00:00:00:00:00:00:00:00:00:00:00:00:00:00:00:00:00:00:00:00:00:00:00:00:00:00:00:00:00:00:00:00:00:00:00:00:00:00:00:00:00:00:00:00:00:00:00:00:00:00:00:00:00:00:00:00:00:00:00:00:00:00:00:01:
01:00:00:00:00:00:00:00:00:00:00:00:00:00:00:00:00:00:00:00:00:00:00:00:00:00:00:00:00:00:00:00:00:00:00:00:00:00:00:00:00:00:00:00:00:00:00:00:00:00:00:00:01:00:00:00:00:00:00:00:00:00:00:00:00:00:00:00:00:00:00:00:00:00:00:00:00:00:00:00:00:00:00:01:
01:00:00:00:00:00:00:00:00:00:00:00:00:00:00:00:00:00:00:00:00:00:00:00:00:00:00:00:00:00:00:00:00:00:00:00:00:00:00:00:00:00:00:00:00:00:00:00:00:00:00:18:01:00:00:00:00:00:00:00:00:00:00:00:00:00:00:00:00:00:00:00:00:00:00:00:00:00:00:00:00:00:00:01:
01:00:00:00:00:00:00:00:00:00:00:00:00:00:00:00:00:00:00:00:00:00:00:00:00:00:00:00:00:00:00:00:00:00:00:00:00:00:00:00:00:00:00:00:23:00:00:00:00:00:00:00:01:00:00:00:00:18:00:00:00:00:00:00:00:00:00:00:00:00:00:00:00:00:00:00:00:00:00:00:00:00:00:01:
01:00:00:00:00:00:00:00:00:00:00:00:00:00:00:00:00:00:00:00:00:00:00:00:00:00:00:00:00:00:00:00:00:00:00:00:00:00:00:00:00:00:00:00:00:00:00:00:00:00:00:00:01:22:00:00:01:01:01:01:00:00:00:00:00:00:00:00:00:00:00:00:00:00:00:00:00:00:00:00:00:00:00:01:
01:00:00:00:00:00:00:00:00:00:00:00:00:00:00:00:00:00:00:00:00:00:00:00:00:00:00:00:00:00:00:00:00:00:00:00:00:00:00:00:10:00:00:00:00:00:18:00:00:01:09:09:01:09:09:01:01:01:01:01:01:00:00:00:00:00:00:00:00:00:00:00:00:00:00:00:00:00:00:00:00:21:00:01:
01:00:00:00:00:00:00:00:00:00:00:00:13:00:13:00:00:00:00:00:00:00:00:00:00:00:00:00:00:00:00:00:00:15:00:00:00:00:00:00:10:00:00:01:01:10:01:01:00:01:09:09:01:09:09:09:09:09:09:09:01:01:00:00:11:11:11:11:11:00:00:00:00:00:00:00:00:00:01:00:00:00:00:01:
01:00:00:00:00:00:00:00:00:00:00:00:00:00:00:00:00:00:19:00:00:00:00:00:00:00:00:00:18:00:00:00:00:00:00:00:00:18:00:00:10:00:00:00:00:00:00:00:00:01:09:09:01:09:09:09:09:09:09:09:09:01:00:00:00:17:00:17:00:00:00:00:00:00:00:00:00:01:01:00:18:00:00:01:
01:00:00:00:00:00:00:00:00:00:00:13:13:13:14:13:00:00:01:01:00:03:03:03:00:00:00:17:01:00:00:01:00:00:00:13:13:13:00:00:10:00:00:00:00:00:00:00:00:01:09:09:01:01:14:01:01:01:01:09:09:01:00:00:00:00:00:00:00:00:01:01:00:00:00:18:01:01:01:00:00:00:00:01:
01:00:00:00:00:00:00:00:00:00:00:00:00:00:00:00:00:00:01:01:00:00:00:00:00:00:00:01:01:00:00:01:01:18:00:00:00:00:00:00:10:00:00:00:00:00:00:00:00:01:09:09:09:09:09:09:09:09:09:09:09:01:01:00:00:00:00:00:00:00:01:01:00:00:00:01:01:01:01:00:00:00:00:01:
01:00:00:00:00:20:00:00:00:00:00:00:00:00:00:22:00:00:01:01:00:00:00:00:00:17:01:01:01:00:00:01:01:01:00:00:00:00:00:01:01:01:00:00:00:00:00:00:18:01:01:09:09:09:09:09:09:09:09:09:01:01:01:01:00:00:19:22:00:00:01:01:00:00:01:01:01:01:01:00:00:00:00:01:
01:01:01:01:01:01:01:01:01:01:01:01:01:01:01:01:01:04:01:01:04:00:00:00:01:01:01:01:01:00:00:01:01:01:01:01:07:01:01:01:01:01:01:05:05:04:06:06:01:01:01:01:01:01:01:01:01:01:01:01:01:01:01:01:01:01:01:01:01:04:01:01:04:01:01:01:01:01:01:04:04:04:04:01:
01:02:02:02:02:02:02:02:02:02:02:02:02:02:02:02:02:02:02:02:02:02:02:02:02:02:02:02:02:02:02:02:02:02:02:02:02:02:02:02:02:02:02:02:02:02:02:02:02:02:02:02:02:02:02:02:02:02:02:02:02:02:02:02:02:02:02:02:02:02:02:02:02:02:02:02:02:02:02:02:02:02:02:02:
