01:01:01:01:01:01:01:01:01:01:01:01:01:01:01:01:01:01:01:01:01:01:01:01:01:01:
01:00:00:00:00:00:00:00:00:22:00:00:00:00:00:00:00:00:00:00:00:00:21:00:00:01:
01:01:15:00:00:00:00:00:00:00:00:00:20:00:00:00:00:00:00:00:14:00:01:00:01:01:
01:00:00:00:00:03:03:03:03:00:00:19:01:00:00:00:00:00:00:00:00:00:01:00:00:01:
01:00:19:01:01:00:00:00:00:00:17:01:01:10:10:10:10:10:01:01:01:01:01:01:00:01:
01:09:01:01:09:09:01:00:00:00:01:01:00:00:00:00:00:00:00:00:00:00:01:00:00:01:
01:09:09:09:09:09:01:01:00:00:00:00:00:00:01:00:00:01:01:01:01:00:01:00:01:01:
01:01:01:01:01:01:01:01:01:03:03:03:01:00:00:01:00:00:00:00:01:00:00:00:00:01:
01:00:00:00:00:00:00:00:00:00:00:00:00:00:00:00:00:00:00:00:01:00:00:01:01:01:
01:00:13:13:13:13:00:00:01:00:00:01:00:00:00:00:00:00:00:01:01:01:00:00:00:01:
01:00:01:00:00:00:13:00:00:00:01:01:00:01:10:10:10:10:10:01:00:00:01:01:00:01:
01:00:00:00:01:00:00:00:01:00:00:01:00:00:00:00:15:00:00:01:00:00:00:00:18:01:
01:00:01:01:01:13:13:13:01:01:00:01:00:01:00:00:00:00:00:01:00:01:01:01:01:01:
01:00:00:00:00:00:00:00:00:00:00:01:00:00:00:00:00:00:00:01:00:00:00:00:00:01:
01:00:01:01:01:01:01:01:00:00:00:01:00:11:00:00:12:00:00:00:01:07:01:01:00:01:
01:09:09:09:09:09:09:01:09:01:00:00:00:00:00:01:01:01:01:00:00:00:01:00:00:01:
01:09:09:09:01:09:09:09:09:01:01:01:01:00:00:00:00:00:00:00:01:00:00:00:01:01:
01:01:01:09:09:09:01:07:01:01:01:01:01:01:04:01:00:01:01:01:01:01:01:01:01:01:
01:02:02:02:02:02:02:02:02:02:02:02:02:02:02:02:02:02:02:02:02:02:02:02:02:01:
