01:01:01:01:01:01:01:01:01:01:01:01:01:01:01:01:01:01:01:01:01:01:01:01:01:01:01:01:01:01:01:01:01:01:01:01:01:01:01:01:01:01:01:01:01:01:01:01:01:01:01:01:01:01:01:01:01:01:01:01:01:01:01:01:01:01:01:01:01:01:01:01:01:01:01:01:01:01:01:01:01:01:01:01:
01:00:00:00:01:00:00:00:11:00:00:00:00:00:00:00:00:00:00:00:00:00:00:00:00:00:01:01:00:00:00:00:00:00:00:00:00:00:00:00:00:00:00:00:00:00:00:00:00:00:00:00:00:00:00:00:00:00:00:00:00:00:00:00:00:00:00:00:00:00:00:00:00:00:00:00:00:01:12:11:00:00:00:01:
01:00:00:00:01:00:00:00:11:00:00:00:00:00:00:00:00:00:00:00:00:00:00:00:00:00:00:01:00:00:00:00:00:00:00:00:00:00:00:00:00:00:00:00:00:00:00:00:00:00:00:00:00:00:00:00:00:00:00:00:00:00:00:00:00:00:00:00:00:00:00:00:00:00:00:00:00:01:12:11:00:21:00:01:
01:00:20:00:01:00:14:00:11:00:00:00:00:00:00:00:00:00:00:00:00:00:00:00:00:00:00:01:00:00:00:00:00:00:00:00:00:00:00:00:00:00:00:00:00:00:00:00:00:00:00:00:00:00:00:00:00:00:00:00:00:00:00:00:00:00:00:00:00:00:00:00:00:00:00:00:00:01:12:11:00:00:00:01:
01:03:03:03:01:00:00:00:11:00:00:00:00:00:00:00:00:00:00:00:00:00:00:00:19:00:00:01:00:07:00:00:07:00:00:00:00:00:00:00:00:00:00:00:00:00:15:00:00:00:00:00:00:00:00:00:00:00:00:00:00:00:00:00:00:00:00:00:00:00:00:00:00:00:00:00:00:01:12:11:00:00:00:01:
01:00:00:00:00:00:00:01:01:00:00:00:00:00:18:00:00:00:00:00:01:01:03:03:03:03:03:01:00:00:00:00:00:00:00:00:00:00:00:00:00:00:00:00:00:00:00:00:00:00:00:00:00:00:00:00:00:00:00:00:00:00:00:00:00:00:00:00:00:00:00:00:00:00:00:00:00:01:12:11:00:00:00:01:
01:00:00:00:00:00:01:01:00:00:00:00:00:00:14:00:00:01:00:00:00:00:11:11:11:11:11:00:00:00:00:00:00:00:00:00:00:00:00:00:00:00:00:00:00:00:18:00:00:00:00:00:00:00:00:00:00:00:00:00:00:00:00:00:00:00:00:00:00:00:00:00:00:00:00:00:00:01:12:11:00:00:00:01:
01:00:00:01:01:01:01:00:00:00:00:00:00:00:00:00:00:01:01:00:00:00:00:00:00:00:00:00:00:00:00:00:00:00:00:00:00:00:00:00:00:00:00:18:00:10:10:00:01:01:00:00:00:00:00:00:00:00:00:22:00:00:00:00:00:00:00:00:00:00:00:00:00:01:00:00:00:01:12:11:00:00:04:01:
01:00:00:00:00:00:00:00:00:00:17:00:00:00:00:18:00:01:01:10:00:00:00:00:00:00:00:00:00:00:01:00:00:00:00:00:14:00:00:00:00:00:00:12:00:00:00:00:00:01:01:00:00:00:00:00:00:00:19:00:00:00:00:00:00:00:00:00:00:00:00:00:12:01:00:18:00:01:12:11:00:00:00:01:
01:00:00:00:00:00:00:00:00:01:00:00:00:13:13:13:13:01:00:00:00:00:00:00:00:00:00:00:00:01:01:00:00:00:00:00:00:00:01:00:10:10:00:00:00:00:00:00:00:00:01:01:17:00:00:00:01:07:23:13:00:00:00:00:00:00:00:00:00:12:14:00:00:01:00:00:00:00:00:00:00:00:00:01:
01:00:00:00:18:00:00:00:00:01:01:00:00:00:00:00:00:00:00:00:00:11:00:00:00:00:00:00:01:01:01:00:00:01:00:00:00:01:01:00:00:00:00:00:00:00:00:00:00:00:01:01:01:00:00:00:00:00:00:00:00:00:00:00:00:00:12:01:00:00:00:00:00:01:00:00:00:00:00:00:00:00:00:01:
01:09:09:09:01:00:17:00:00:01:01:00:00:00:00:00:00:00:00:12:11:11:00:00:00:00:00:01:01:01:01:00:00:01:00:00:01:01:01:00:00:00:00:00:00:00:00:00:00:01:01:01:01:01:00:00:00:22:00:00:00:00:00:12:01:00:00:00:00:00:00:00:00:01:00:00:22:00:01:00:00:00:00:01:
01:09:09:09:01:01:01:01:04:01:01:01:05:05:05:05:05:05:05:01:01:01:00:00:00:00:00:01:01:01:01:00:00:01:01:01:01:01:01:00:00:00:00:00:00:00:00:00:01:01:01:01:01:01:01:01:01:01:01:01:01:01:01:01:01:01:01:01:01:01:01:01:01:01:04:01:01:01:01:01:04:04:01:01:
01:02:02:02:02:02:02:02:02:02:02:02:02:02:02:02:02:02:02:02:02:02:02:02:02:02:02:02:02:02:02:02:02:02:02:02:02:02:02:02:02:02:02:02:02:02:02:02:02:02:02:02:02:02:02:02:02:02:02:02:02:02:02:02:02:02:02:02:02:02:02:02:02:02:02:02:02:02:02:02:02:02:02:02:
